22222222222222222222
11133321113111211111
11211222211222211211
11241111111111114211
11221122213222112211
11133112311133211333
11211121144432112211
22113344411311122111
11211123444322112211
11113331131221133311
12221122212221112231
32111111111111111123
22142322211222224211
11113211113322113111
22222222222222222222
-----
(0,1) (4,8) (7,11) (11,11)
-----
(0,13) (19,13) (19,1) (9,3)
-----
a b c d e f g h i
-----
Alice Bob Tom Jerry